R 1080 720

F
C

NO
SO
WE
EA

S

11111111111
1000000S001
10200000001
10000000001
10000000001
10000200001
10000000001
10000000001
10000000001
11111111111