R 3080 2720

F 130,196,108
C 81,203,247

NO ./textures/Bougainvilliers.xpm
SO ./textures/Bougainvilliers.xpm
WE ./textures/wood.xpm
EA ./textures/greystone.xpm

S ./textures/Marble_statue.xpm

11111111111
10000S00001
10200000001
10000011001
10000000001
10000200001
10000000001
11111000001
10000020001
11111111111