R 1080 720

F 247,217,133
C 81,203,247

NO ./textures/Bougainvilliers.xpm
SO ./textures/Bougainvilliers.xpm
WE ./textures/Bougainvilliers.xpm
EA ./textures/Bougainvilliers.xpm

S ./textures/Marble_statue.xpm

11111111111
1000000S001
10200000001
10000000001
10000000001
10000200001
10000000001
11111100001
10000000001
11111111111