R  1080 720
NO ./textures/purplestone.xpm
SO ./textures/bluestone.xpm
WE ./textures/wood.xpm
EA ./textures/greystone.xpm

S ./textures/chest.xpm
F 224,172,105
C 205,249,255

11111111111111111111111111111
10000000001100000000000000001
10110000011100020000000010001
10120000000000000000000010001
10110000011100000000000010001
10000000001100000111011110001
11110111111111011100000010001
11110111111111011101010000001
11000000110101011000000000001
10002000000000000000000000001
10000000000000001101010010001
1100N000110101011111011110001
11110111111101011111011110001
11111111111111111111111111111